+++++++++++++++++++++
+   +   ++ ++     
+ +   +       +++  ++
+ + +  ++  ++++    ++
+++ ++++++    +++   +
+          ++  ++   +
+++++ ++++++   ++++ +
+     +   +++++++ + +
+ +++++++      S +  +
+                ++++
+++++++++++++++++++++
